################################### #####################################
#                   #           #     #           #         #   #   #   #
# ######### ##### ### ### ####### ### # ########### ##### # # # # # # # #
# #     #   #   # #   # # #     #   # #     #     #     # #   #   # # # #
# # ### # ### # # # ### # # ### ### # # ### # ### ### ### ######### ### #
# # #   # # # # # #   # #   # #     # #   #   # #     #   #   #         #
# # # ### # # # ##### # ##### ####### ### ##### ####### ### # ###########
#   # # #   # # #     #           #   # #   #         #   # #           #
##### # ### # # # ######### # # ### ### ### ##### ### ### # ########### #
#   # #     # #   #       # # # #   #     #     #   #   # # #       #   #
# # # ####### ##### # ### ### # # ### ######### ##### # # # ##### ### # #
# #   #       #   # # #       # # # #         #       # # # #   #   # # #
# ##### ####### # # # ########### # # ####### ######### # # # # ### # ###
#       # #     #   # #   #     # # # #     #       #   # #   # #   #   #
# ####### # ####### # # # # ### # # # ##### # ####### ### ##### # ##### #
# #     #   #     # #   # # #     # # #     #       # # #   #   #     # #
# ### # ### # ### # ##### # ####### # # ### ####### # # # ### ##### ### #
#   # #   # # #   # #   # #     #       # #   #     # # #     #     #   #
### # ### ### ### # # # # ##### ######### ### # ##### # ######### ### # #
# # #   #   #   # #   # #     #         #     #           #       #   # #
# # # # ### ### # # ######### ######### ##### ########### ##### ### ### #
# # # #   #   # # # #     #         #   #   # #       # # #   # #   #   #
# # ##### ### # # ### ### # # ##### # # # # # # ##### # # # # # # ### ###
# # #   # # #   #     #   # # #   # # # # # # # #   # #     #   # # #   #
# # # # # # ########### ### ### # # # ##### ### # # # ########### # ### #
# #   # # #   #       # #       # # #       #   # # # #       #   #     #
# ##### # # # # ##### # ######### # ######### ### # # # ##### # ### #####
#         # #       #             #           #   #     #       #       #
#####################################&###################################
